............
.....#......
.....#...#..
..o..#..#*..
.....#......
.....######.
............
