#######################
#.....................#
#...............##....#
#...o...........##....#
#...............##....#
#...............##....#
#...............##....#
#...............##....#
#...............##....#
#...............##....#
#...............##....#
#...............##....#
#...............##....#
#...............##....#
#...............##....#
#...............##....#
#...............##....#
#...............##....#
#...............##....#
#...............##....#
#...............##....#
#...............##....#
#...............##....#
#.################....#
#................#....#
################.#....#
#................#....#
#.################....#
#.................*...#
#######################
