............
.....#......
.....#...#..
..o..#..#*#.
.....#...#..
.....######.
............
