.................
........#........
........#.*......
........#........
........#........
........#........
........#........
........#........
........#........
.o......#........
........#........
.................