#######################
#.....................#
###..............#....#
#o#..............#....#
#................#....#
#................#....#
#................#....#
#................#....#
#................#....#
#................#....#
#................#....#
#................#....#
#................#....#
#................#....#
#................#....#
#................#....#
#................#....#
#................#....#
#................#....#
#................#....#
#................#....#
#................#....#
#................#....#
#.################....#
#................#....#
################.#....#
#................#....#
#.################....#
#.................*...#
#######################
