............
...#.*......
...#........
...#........
...#........
...#........
...#........
...#........
...#........
...#........
..o.........
............
