.................
.................
.................
..#############..
..............#..
..............#..
..............#..
.o............#..
..............#..
..............#..
..............#..
..............#..
..#############..
...............*.
.................
.................
